cohort,week,weekly_active_users,weeks_since_signup,total_signups_per_cohort,pct_active
18,18,424,0,424,100
18,19,413,1,424,97.41
18,20,416,2,424,98.11
18,21,411,3,424,96.93
18,22,408,4,424,96.23
18,23,405,5,424,95.52
18,24,412,6,424,97.17
19,19,57,0,57,100
19,20,47,1,57,82.46
19,21,45,2,57,78.95
19,22,41,3,57,71.93
19,23,46,4,57,80.7
19,24,49,5,57,85.96
20,20,10,0,10,100
20,21,6,1,10,60
20,22,7,2,10,70
20,23,5,3,10,50
20,24,8,4,10,80
21,21,2,0,2,100
22,22,1,0,1,100
24,24,1,0,1,100
